111111
100001
1P00C1
1E00C1
111111