1111111111111
100C000000001
1000000000001
100P0C0000001
100000000E001
100C000000001
1111111111111