1111111111
1P10000001
1C00000001
100CC000E1
1111111111