1111111111111111111111111
10000P000000000C000000001
1000000000000000000011111
1000000000001100001000001
100000000E000000000000001
1000001001111111100000001
1111111111111111111111111
