1111111111
1P10000001
1C00000001
100EC00001
1111111111