1111111111
100P000C01
1000C00001
1000001E01
1111111111
